11111111
100000E1
1PC00001
10000011
11111111