11111111111111111111111111111111111111
11101101110111110111101110111101111111
11111111111111111111111111111111111111
1010000E00000000C0000000000000000111C1
101101010010000010100100000001010111C1
101001001010101001100100000001010111C1
100001000000000001100000000000000000C1
11111111111111111P001111111110111111C1
11111111111111111111111111111111111111